#############
##S##.T.#E..#
##T##.#...#.#
#.E##E#####T#
#T###.#E....#
#.E...#.#####
###T###..E..G
#############