#########
##S##.T.#
##T##.#.#
#.E##.#.#
#T###.#E#
#.E...#.#
###T###.G
#########