#########
##S##.T.#
##G##.#.#
#.E##.#.#
#T###.#E#
#.E...#.#
###T###.G
#########
2
#############
##S##.T.#E..#
##T##.#...#.#
#.E##E#####T#
#T###.#E....#
#.E...#.#####
###T###..E..G
#############
3
#############
#S.##.T.#E..#
##T##.#...#.#
##E...#####T#
#T#####E....#
#.E.....#####
#.#T####....G
#.E.T...E####
#############