#########
##S##.T.#
##G##.#.#
#.E##.#.#
#T###.#E#
#.E...#.#
###T###.G
#########
1
#############
##S.E..T.E..#
###########.#
#.T##E#####T#
#E###..E....#
#.E...#######
###T###..E..G
###..E....###
#############
2
#############
#S.##.T.#E..#
##T##.#...#.#
##E...#####T#
#T#####E....#
#.E.....#####
#.#T####....G
#.E.T...E####
#############
3