#S##.T.#
#.##.#.#
.E##.#.#
T###.#E#
.E...#.#
##T###.G