#############
#S.##.T.#E..#
##T##.#...#.#
##E...#####T#
#T#####E....#
#.E.....#####
#.#T####....G
#.E.T...E####
#############